################################################
#                                              #
#                                              #
#                                              #
#                                              #
#                                              #
#    o                                         #
#                                              #
#                                              #
#                                              #
#                                              #
#                                              #
#                                              #
#                                              #
#                                              #
################################################